10
10
XXXXXXXXXX
XOOOOOOOOX
XOOOOOOOOX
XOOOOOOOOX
XOOOPOOOOX
XOOOOOOOOX
XOOOOOOOOX
XOOOOOOOOX
XOOOOOOOOX
XXXXXXXXXX